11111111111
10N00000001
10CN0000001
10000000001
1000C000P01
1C10010C0E1
11111111111
10000000011
11111111111