111111111
110000001
100000011
11P00E0C1
100000011
111111111